111111111111111111111111111111111111111111111111111111111110
100000000000000000000000000000000000000000000000000000000000
1000P000000000000000000C000000000000000000C00000000000000000
222222200000000000000022200002200000000000200000000000000000
100000000000000000000000000000000000000000000000000000000000
100000000000000000000000000000000000000000000000000000000000
100000000000000000000000000002200000000200000022000000000000
100000000000000000000000000000000000000000000002000000000000
10000000000000000000000220000000000000000020000200000000E000
1C0000000000000000000000000000000000000000000002000000000000
120000000000000022222222222222222220000002222222000000222220
100000000000000222222222222222222220000002222222000000222220
100000000000000000000000002200000000000000000000000000000220
120000000000000000000000002200000000000000000000000000000220
100002222222222220000000002200000000000000000000000000000220
1000022222222220000000200C2200000000000000000000000000000220
100002200000022000020000022200000000000000000000000000000220
100002200000022C00000000002200000000000000000000000000000220
100002200000022200000000002200000000000000000000000000000220
LLLLL22LLLLLL22LLLLLLLLLLL22LLLLLLLLLLLLLLLLLLLLLLLLLLLLL22L

