11111111111111111111111111111111111
10000000000000000000000000000000001
1000P000000000000000000C00000000001
22222220000000000000002220000220001
10000000000000000000000000000000001
10000000000000000000000000000000001
10000000000000000000000000000220001
10000000000000000000000000000000001
10000000000000000000000220000000001
1C000000000000000000000000000000001
12000000000000002222222222222222221
10000000000000022222222222222222221
10000000000000000000000000220000001
12000000000000000000000000220000001
10000222222222222000000000220000001
1000022222222220000000200C220000001
10000220000002200002000002220000001
100002200000022C0000000000220000001
10000220000002220000000000220000001
LLLLL22LLLLLL22LLLLLLLLLLL22LLLLLLLL

