11111111111111111111111111111111111111111111111111111111111
1P0000000E0000000000000000000000000000000000000000000000001
10110001100000000000000000000000000000000000000000000000001
1010C000100000000000000000000000000000000000000000000000001
10000100000000000000000000000000000000000000000000000000001
10001110000000000000000000000000000000000000000000000000001
100001F0000000000000000000000000000000000000000000000000001
10100000100000000000000000000000000000000000000000000000001
1C110001100000000000000000000000000000000000000000000000001
100000C0000000000000000000000000000000000000000000000000001
10000100000000000000000000000000000000000000000000000000001
10001110000000000000000000000000000000000000000000000000001
10000100000000000000000000000000000000000000000000000000001
10001110000000000000000000000000000000000000000000000000001
10000100000000000000000000000000000000000000000000000000001
10001110000000000000000000000000000000000000000000000000001
10000100000000000000000000000000000000000000000000000000001
10001110000000000000000000000000000000000000000000000000001
10000100000000000000000000000000000000000000000000000000001
10001110000000000000000000000000000000000000000000000000001
10000100000000000000000000000000000000000000000000000000001
10001110000000000000000000000000000000000000000000000000001
10000100000000000000000000000000000000000000000000000000001
10001110000000000000000000000000000000000000000000000000001
10000100000000000000000000000000000000000000000000000000001
10001110000000000000000000000000000000000000000000000000001
10000100000000000000000000000000000000000000000000000000001
10001110000000000000000000000000000000000000000000000000001
10000100000000000000000000000000000000000000000000000000001
11111111111111111111111111111111111111111111111111111111111