11111111111111111111111111111111111
10000000000000000000000000000000001
10000000000000000000000000000000001
10000000000000000000000000000000001
10000000000000000000000000000000001
10000000000000000000000000000000001
10000000000000000000000000000000001
10000000000000000000000000000000001
12222222000000000000022222000000001
10000000000000000000000000000000001
1000000000222220P000000000000222221
10000000000000022220000000000000001
10000000000000000000000000000000001
10000000000000000000000000002222201
10000000000000000022222220000000001
10000000000000022222222200000000001
10000000000022222222200200000000001
12222222222200000000000000000000001
10000000000000000000000000000000001
11111111111111111111111111111111111

