11111111111111111111111111111111111
10000000000000000000000000000000001
10000000000000000000000000000000001
10000000000000000000000000000000001
10000000000000000000000000000000001
10000000000000000000000000000000001
10000000000000000000000000000000001
10P00000000000000000000000000002221
12222200000000000000022222000000001
10000000000000000000000000000000001
10000000002222200000000000000222221
10000000000000000000000000000000001
10000000000000000000000000000000001
10000000000000000000000000002222201
10000000000000000022222220000000001
10000000000000000000000000000000001
10000000000000000000000000000000001
10000000000000000000000000000000001
10000000000000000000000000000000001
11111111111111111111111111111111111

