1111111111111111111111111111111111111111111111111
1000000000000000000000000000000000000000000000001
1000000000000000000000000000000000000000000000001
1000000000000000000000000000000000000000000000001
10000000000000000000000000000000000000000000000E1
1000000000000000000000000000000000000000000222221
1000000000000000000000000000000000000000222200001
10P0000000000000000000000000000222220000000000001
1222220000000000000002222200000000000000000000001
1000000000000000000000000000000000000000000000001
1000000000222220000000000000022222000000000000001
1000000000000000000000000000000000000000000000001
1000000000000000000000000000000000002222220000001
1000000000000000000000000000222220000000000000001
1000000000000000002222222000000000000000000000001
1000000000000000000000000000000000000000000000001
1000000000000000000000000000000000000000000000001
1000000000000000000000000000000000000000000000001
1000000000000000000000000000000000000000000000001
1111111111111111111111111111111111111111111111111
